NO ./textures/wood.xpm
SO ./textures/wood.xpm
WE ./textures/wall_3.xpm
EA ./textures/wall_4.xpm

F 222,252,249
C 204,168,233


1111111111111111111111111
1000000010010000000001001
1100010000000000010000011
1000000111111111011111111
1000000111111111011
100S000000000000001
1000000111111111111
10000001
10000001
11111111